--------------------------------------------------------------------------------------------------------------------------------------------------------------------------------------------------------
--------------------------------------------------------------------------------------------------------------------------------------------------------------------------------------------------------
--------------------------------------------------------------------------------------------------------------------------------------------------------------------------------------------------------
--o--MXo-o-----o----X--------o-------o---------B-----XX---ooB---X-----B-?---o------Bo-B---oMX-------------------?-----oX-X--o---o-------------X--X------------o-M-XoX-----------B-------?-----o--X--?---
-----------M-X--o-----------------X------ooM---XX--X-----o-------?B-------oX--------------------B--o---ooX-XX-------------B--B---B----o--X-Xo?---B------------------o-B----X-----oM-o----BX--M-------o--
--M----X-o---B---X------B--------M-X---B----------X----X-B----------o--o----o----Bo---------o----o------X-X--------o--B------------X---o------X-------------XB-XM----oo-o---?ooX------X-X---------------
---MoXB--------------X---X-X-BB-------XB--?-o--X---------------------------o------X---B-X-------------X---X----------------X-------------X--o-----------B-----B------o--------------X---------BoX--B-?--
---------X--X-E--X?---?---Bo--------o------X-X-o---X------o--X-------------o-X-BX--------B-XX-B---M---X-X------------B-XM-----o-?-o----o--o------XX---Xo---------?--------XBo-------o-o-B--XX-o-Xv?----v
-----M-MX-o---X-----X----o-----B-------o-----------E---------X--X--M----BE--------o----------X------Xo----------------B----X--X------------X-X-X-----X---X------------------------M--o-------------X--Bf
--oX-----BX----?-o-o-------BX-o---------------XB---BXM-XoX-o-----o--E-M--X?--X-------o-X--------B-X-------XX------X--------------------oo--------------X-----XX-------B-----M-o--------B------o-------of
------oM-B---------o-----X----------BB----XMo---------M------X------B------BXo----BXM-X----o---oo-----X-B--o---B-B----?--MX---X--BoX----o----B----?Xo-X--o--o--o-XMX?----o-------X-o--X----o------B-X--f
--B--------B-B-?-----B-X--o------------------o--o-B--------------o-----oMoo-------X---o-?----X-B-o--------X---X-X--o--------o-------M-----Xo--------------?--o---------------------------X---M-?---X---f
-X-------B-o-------o-B--B---o----o----?-o--o---------o--------X---B--------X-XB-X---o-----XB-------------X--X---X-----B---o-----------X------X--B--X-oX-----X--?-------B--oX----?---B---B---------o-BB-f
----o-----X--------XX----X--o------------X----X-----M-----?----BBB----B-X--XXo-o-XX-----------X----X----oX?------X---B-----X---?-XB---o?-B-o--o-BX----------oo---M-----X--XX--?---B----X-------B---B-BBf
m--B----------------------Bo--X---------X--o-X---XX--XX-----B----X-X--X---oBo--BX--o-----o----------Bo-----oX----X-----X--X-----o-------X-------------o--BX---------B--B---------XB--XX----X--Xo----X-oX
XXXXXXXXX--XXXX-XXXXX-XXXXXXXXXX-XX-XXXXXXXX-XXXXXXXXXXXXXXXX-XXXXXXXXX-XXXXXXXXXXXX-XXXXXXX--XXXXXXXXX-XXXXXXXXXXXXXX-X-XXXXXX-XXXXXXXXXXXXXXXXXXXXXXXXXXXXXXXXXXXXXXXXXXXXXXXXXXXXXXXXXXXXXXXXXXXXXXXX
